NO textures/ice.xpm
SO textures/lava.xpm
WE textures/bricks.xpm
EA textures/leaves.xpm

F 101,183,65
C 123,211,234

11111111111
10000010111
10000010101
10000010111
1N00001
1111111