NO textures/ice.xpm
SO textures/lava.xpm

WE textures/bricks.xpm
EA textures/leaves.xpm

F 101,183,65



C 123,211,234


11111111111111
10000000000001
10000000000001
10000000000001
10000000100001
10W00000000001
11111111111111