NO textures/ice.xpm
SO textures/lava.xpm
WE textures/bricks.xpm
EA textures/leaves.xpm

F 101,183,65
C 123,211,234

1111111           1111111111111
1000001111111     1000000000001111111111111111111111111111111111111111111111111
1000000000001111111000111110000000000000000000000000000000000000000000000000001
10000000000000000000001   1001111111110000000000000000000000000000000000000W001
1000001111111111111111111110111      100000000000000000000000000000000000000001
1101111                   101        100000000000000000000000000000000000000001
1101      11   111  11  11101        111111111111111111111111111111111111111111
11011111111111111111111111001
11000000000000000000000000011
11111111111111111111111111111