NO textures/N
SO textures/S
WE textures/W
EA textures/E

F 20,20,215
C 200,200,200

11111
10001
10S01
10001
1 111
11111