1111111111111111111111111
1000000000000000000001
1000000000W00000001
100000000000000000001
111111111111111111111111
