1111111111111111111111111
1000000000000000011111
100000000000000001
10000000000000000111
1111111111111111111111