NO ./textures/N
SO ./textures/S
WE ./textures/W
EA ./textures/E
F 50,50,50
C 50,50,50


11111111111111111111111111111111
       1000000000001
       1000000000001
       1000S00000001
       1000000000001
       1000000000001
       1000000000001
       1000000000001
       1000000000001
       1000000000001
       1000000000001
       1000000000001
       10000000000011111111111111111111111111111111111111111111
       10000000000000000000000000000000000000000000000000000001
       10000000000000000000000000000000000000000000000000000001
       10000000000000000000000000000000000000000000000000000001
       10000000000000000000000000000000000000000000000000000001
       10000000000000000000000000000000000000000000000000000001
       11111111111111111111111111111111111111111111111111111111