11111111111111111111111111
1000P000000000000000000001 
10000000000011111000000001
10000000000011111000000001
10000000000011111000000001
10000000000000000000000001
10000000000000000000000001
11111111111111111111111111