111111111111111
100P00000000001
100000000011001
100000000011001
100000000000001
100000000011101
100011000010001
100011000010001
111111111111111