111111111111111
1P1000000000001
101010011011001
101010000011001
101010000000001
101010000011101
100011000010001
100011000010001
111111111111111