1111111111111111111111111
1000100000000000000000001
1000100000000000000000001
1000100000000000000000001
1000100000000000000000001
1000100000000000000000001
1000111111100000000000001
1000000000000000000000001
10000000000P0000000000001
1000000000000000000000001
1000000000000000000000001
1000000000000000000000001
1000000000000000000000001
1000000000000000000000001
1000000000000000000000001
1000000000000000000000001
1000000000000000000000001
1000000000000000000000001
1000000000000000000000001
1111111111111111111111111