NO ./textures/N
SO ./textures/S
WE ./textures/W
EA ./textures/E
F 0,10,10
C 50,0,10


111111
1N1
11  1
111111