

NO               ./textures/N

SO                 ./textures/S

        
WE      ./textures/W
            
EA     ./textures/E

F 00,00,00
C 255,255,255

	

1111111111   1
11111110101 101
10000N00001  1
10000001001
10000000011
11111111111   1    


